ADJP	r ADJP JJ;r AD NN CS;r
ADVP	r ADVP AD;r
CLP	r CLP M;r
CP	r DEC SP;l ADVP CS;r CP IP;r
DNP	r DNP DEG;r DEC;r
DP	l DP DT;l
DVP	r DVP DEV;r
FRAG	r VV NR NN;r
INTJ	r INTJ IJ;r
IP	r IP VP;r VV;r
LCP	r LCP LC;r
LST	l LST CD OD;l
NP	r NP NN NT NR QP;r
PP	l PP P;l
PRN	r NP IP VP NT NR NN;r
QP	r QP CLP CD OD;r
UCP	r
VCD	r VCD VV VA VC VE;r
VCP	r VCP VV VA VC VE;r
VNV	r VNV VV VA VC VE;r
VP	l VP VA VC VE VV BA LB VCD VSB VRD VNV VCP;l
VPT	r VNV VV VA VC VE;r
VRD	r VRD VV VA VC VE;r
VSB	r VSB VV VA VC VE;r
WHNP	r WHNP NP NN NT NR QP;r
WHPP	l WHPP PP P;l
